WWWWWWWWWWWWWWWWWWWWWWWWWWWW
WCCCCCCWWCCCCCCCCCCWWCCCCCCW
WCWWWWCWWCWWWWWWWWCWWCWWWWCW
WCWWWWCWWCWWWWWWWWCWWCWWWWCW
WCWWCCCCCCCCCWWCCCCCCCCCWWCW
WCWWCWWWWCWWCWWCWWCWWWWCWWCW
WCWWCWWWWCWWCCCCWWCWWWWCWWCW
WCWWCWWWWCWWCWWCWWCWWWWCWWCW
WCCCCCCCCCWWCWWCWWCCCCCCCCCW
WCWWWWCWWCWWCWWCWWCWWCWWWWCW
WCWWWWCWWCWWCWWCWWCWWCWWWWCW
WCCCCCCWWCCCCCCCCCCWWCCCCCCW
WCWWCWWWWCWWWCCWWWCWWWWCWWCW
WCWWCWWWWCWCCCCCCWCWWWWCWWCW
WCWWCCCCCCWCWWWWCWCCCCCCWWCW
WCWWWWCWWCWCWWWWCWCWWCWWWWCW
WCWWWWCWWCWCWWWWCWCWWCWWWWCW
WCCCCCCWWCCCCCCCCCCWWCCCCCCW
WCWWCWWWWWWWCWWCWWWWWWWCWWCW
WCWWCWWWWWWWCWWCWWWWWWWCWWCW
WCWWCCCCCCCCCWWCCCCCCCCCWWCW
WCWWWWWWWCWWWWWWWWCWWWWWWWCW
WCWWWWWWWCWWWWWWWWCWWWWWWWCW
WCCCCCCCCCCCCCCCCCCCCCCCCCCW
WCWWWWCWWCWWWWWWWWCWWCWWWWCW
WCWWWWCWWCWWWWWWWWCWWCWWWWCW
WCWWCCCWWCWWCCCCWWCWWCCCWWCW
WCWWCWWWWCWWCWWCWWCWWWWCWWCW
WCWWCWWWWCWWCWWCWWCWWWWCWWCW
WCCCCCCCCCCCCWWCCCCCCCCCCCCW
WWWWWWWWWWWWWWWWWWWWWWWWWWWW